FE8 - Fields - 01000203
15 20
460 585 523 417 618 492 614 513 461 779 459 496 807 808 809 559 523 619 576 461
492 582 523 491 492 460 582 715 780 164 781 592 839 840 841 130 495 587 556 576
429 585 417 386 492 492 592 163 164 782 163 164 871 872 873 162 594 523 587 556
460 550 491 429 492 560 131 132 198 199 162 163 202 330 299 783 99 594 523 587
461 779 715 714 592 268 324 390 300 294 327 272 200 303 162 815 131 493 417 386
592 131 260 337 337 295 326 99 774 720 234 304 304 325 269 163 164 462 491 461
145 273 231 720 164 742 742 384 385 777 165 686 685 234 328 203 162 463 555 544
305 231 165 743 591 579 579 459 429 497 384 481 561 131 302 241 591 524 619 422
133 743 591 481 583 523 417 618 460 615 417 618 592 782 397 365 495 555 556 422
591 481 614 459 429 550 491 429 460 614 616 528 131 132 298 235 495 587 556 616
550 616 582 459 460 551 619 512 460 614 545 496 163 164 720 99 559 524 619 544
513 429 615 616 492 582 587 588 512 421 618 465 165 784 785 131 163 495 619 490
583 580 523 513 429 460 583 523 417 618 464 592 15 131 880 882 162 559 587 588
585 555 416 678 513 492 585 417 618 432 140 70 103 880 912 946 163 164 559 523
582 619 546 418 386 492 582 616 428 656 113 6 71 944 946 162 163 720 163 559
